+--+--+-S+--+--+--+--+--+--+--+--+--+--+--+--+--+--+--+--+--+
|        |     |              |        |     |              G
+  +  +--+  +  +  +--+--+  +  +  +--+  +  +  +  +--+--+  +--+
|  |  |     |        |     |     |  |  |  |           |     |
+  +  +  +--+--+--+  +  +--+--+--+  +  +--+--+--+--+  +--+  +
|  |     |     |     |  |     |     |        |     |  |     |
+  +--+--+  +  +--+  +  +  +  +  +--+--+--+  +  +  +--+  +--+
|  |        |     |  |     |  |  |           |  |     |     |
+  +  +--+  +--+  +--+--+--+  +  +  +--+--+--+  +--+  +--+  +
|  |  |  |     |     |     |  |                 |  |     |  |
+  +  +  +--+--+--+  +  +  +  +--+--+--+--+--+--+  +--+  +  +
|  |  |     |        |  |  |     |                 |     |  |
+  +  +--+  +  +--+--+  +  +--+  +  +  +--+--+--+  +  +--+  +
|  |  |  |     |        |        |  |  |     |     |  |     |
+  +  +  +--+--+  +  +--+--+--+--+--+  +  +--+  +--+  +--+  +
|  |     |        |  |                 |     |     |  |     |
+  +--+  +  +--+--+  +  +--+--+--+  +--+--+  +  +--+  +  +  +
|  |  |  |  |        |  |     |  |  |     |     |     |  |  |
+  +  +  +--+  +--+--+  +  +  +  +  +  +  +--+--+  +--+  +  +
|     |        |           |     |     |                 |  |
+--+--+--+--+--+--+--+--+--+--+--+--+--+--+--+--+--+--+--+--+