+--+--+--+--+--+--+--+--+--+--+--+--+--+-G+--+--+--+--+--+--+
|        |        |           |           |              |  |
+  +--+  +  +--+  +  +--+  +  +  +  +--+  +  +--+--+--+  +  +
|  |        |     |     |  |  |  |     |     |        |     |
+  +--+--+--+--+  +--+  +  +--+  +--+  +--+--+  +--+--+--+  +
|              |  |     |           |  |     |           |  |
+  +--+--+--+  +--+  +--+--+--+--+  +  +  +  +  +--+  +--+  +
|  |        |     |     |     |     |  |  |        |  |     |
+  +  +--+  +--+  +--+  +  +  +--+--+  +  +--+--+--+  +  +--+
|     |  |  |  |     |  |  |        |  |  |     |     |  |  |
+--+--+  +  +  +  +--+  +  +--+--+  +  +  +  +--+  +  +  +  +
|     |     |  |        |     |     |  |     |     |  |     |
+--+  +  +--+  +--+--+--+--+  +  +--+  +  +--+  +--+--+--+  +
|     |     |        |  |     |        |  |     |        |  |
+  +  +--+  +--+  +  +  +  +--+--+--+--+  +  +--+  +  +--+  +
|  |  |     |     |     |     |     |     |        |     |  |
+  +--+  +--+  +--+--+--+--+  +  +  +  +--+--+--+--+--+  +  +
|     |  |        |           |  |  |  |        |     |     |
+  +  +  +--+--+  +  +--+--+--+  +  +  +  +--+  +  +  +--+--+
|  |              |              |  |     |        |        |
+--+S-+--+--+--+--+--+--+--+--+--+--+--+--+--+--+--+--+--+--+