+--+--+--+--+--+--+--+--+--+--+--+--+--+--+--+--+--+--+--+--+
|           |        |              |                       |
+  +  +--+--+  +--+  +  +--+--+  +--+  +--+--+--+  +  +--+--+
|  |     |     |  |  |        |        |     |     |  |     |
+  +--+  +  +--+  +  +--+  +--+--+--+  +  +  +  +--+  +  +  +
|  |  |     |     |        |        |  |  |     |     |G |  |
+  +  +--+--+  +  +--+--+--+  +--+  +--+  +--+--+--+  +--+  +
|  |           |  | S      |  |           |        |  |     |
+  +--+--+--+  +  +  +--+  +  +--+--+--+--+  +--+  +--+  +--+
|              |  |     |  |                 |  |        |  |
+--+--+--+--+--+  +--+  +--+  +--+--+--+--+--+  +--+--+--+  +
|     |           |     |           |     |                 |
+--+  +  +--+--+--+  +--+  +  +--+  +  +  +  +  +--+--+--+  +
|     |           |  |     |  |     |  |  |  |     |        |
+  +--+--+--+--+  +  +  +--+  +  +--+--+  +  +--+  +  +--+--+
|              |  |  |  |     |        |     |     |        |
+  +--+--+--+  +  +  +  +  +--+--+--+  +--+--+  +--+--+--+  +
|  |        |     |     |  |  |        |        |     |     |
+  +--+  +  +--+--+--+--+  +  +  +--+--+  +--+--+  +--+  +--+
|        |                 |              |                 |
+--+--+--+--+--+--+--+--+--+--+--+--+--+--+--+--+--+--+--+--+