+--+--+--+--+--+--+--+--+--+--+--+--+--+--+--+--+--+--+--+--+
|              |                 |     |        |           |
+  +--+  +--+--+  +--+  +--+--+  +  +--+  +  +--+  +--+--+  +
|   G |           |     |     |  |  |     |        |     |  |
+--+--+  +--+--+--+  +--+  +  +  +  +  +--+--+--+--+  +  +  +
|     |           |        |  |     |           |     |  |  |
+  +--+--+--+--+--+--+  +--+  +--+  +--+--+--+  +  +--+  +  +
|  |     |           |S |     |        |        |  |  |  |  |
+  +  +  +  +--+--+  +--+  +--+--+--+--+  +--+--+  +  +  +  +
|  |  |     |     |     |                 |        |     |  |
+  +  +--+--+  +  +--+  +--+--+--+--+--+--+  +--+--+  +--+  +
|     |        |     |        |              |  |     |     |
+--+--+  +--+  +  +--+--+--+  +  +--+--+--+--+  +  +--+--+  +
|  |     |     |  |        |  |  |     |     |     |     |  |
+  +  +--+  +--+--+  +--+  +  +  +  +--+  +  +  +--+  +  +  +
|     |  |     |        |  |  |  |     |  |  |     |  |  |  |
+  +--+  +--+  +  +--+--+  +  +  +  +  +  +  +--+  +  +  +  +
|  |        |     |  |     |  |  |  |  |  |     |     |     |
+  +  +--+  +--+--+  +  +--+  +  +  +  +  +--+  +--+--+--+  +
|     |              |           |  |        |              |
+--+--+--+--+--+--+--+--+--+--+--+--+--+--+--+--+--+--+--+--+