+--+--+--+--+--+--+--+--+--+--+--+--+--+--+--+--+--+--+--+--+
S        |  |     |        |        |                    |  |
+  +--+  +  +  +  +  +--+  +  +  +  +  +--+--+  +--+--+  +  +
|     |     |  |     |  |     |  |  |  |     |        |     |
+  +  +--+  +  +--+--+  +--+--+  +--+  +  +  +--+--+  +--+  +
|  |     |  |  |           |  |        |  |        |     |  |
+  +--+  +--+  +--+--+  +  +  +--+--+--+  +--+  +  +--+  +--+
|     |        |     |  |     |        |     |  |     |     |
+  +  +--+  +--+  +  +  +--+--+  +  +--+  +--+  +--+  +--+  +
|  |     |        |     |  |  |  |        |     |     |     |
+  +--+  +  +--+--+--+--+  +  +--+--+--+--+  +--+  +--+  +  +
|  |  |  |        |        |              |     |     |  |  |
+  +  +  +  +--+  +--+  +  +--+--+--+--+  +  +  +--+  +  +--+
|  |        |  |     |  |  |           |  |  |  |     |     |
+  +--+--+--+  +--+  +  +  +  +--+  +--+  +--+  +--+--+--+  +
|        |        |  |  |     |  |                          |
+  +--+  +  +  +--+  +--+--+  +  +--+--+--+--+--+  +--+--+  +
|  |     |  |     |  |     |     |     |        |        |  |
+--+  +--+  +--+  +  +  +  +--+--+  +  +  +--+  +--+--+  +  +
|              |        |           |     |              |  G
+--+--+--+--+--+--+--+--+--+--+--+--+--+--+--+--+--+--+--+--+


