+--+--+--+--+--+--+--+--+--+--+--+--+--+--+--+--+--+--+--+--+
|              |        |     |                    |        |
+  +  +--+--+  +--+  +  +--+  +  +  +--+--+--+--+  +--+--+  +
|  |  |     |        |     |     |           |              |
+  +--+  +  +--+--+--+--+  +--+  +--+--+--+  +--+--+--+--+  +
|     |  |     |        |     |        |     |           |  |
+  +  +  +--+  +  +--+  +--+  +--+  +--+  +  +  +--+--+  +  +
S  |  |  |  |     |  |     |     |  |     |  |     |  |  |  |
+--+  +  +  +--+--+  +--+--+--+  +--+  +--+--+--+  +  +  +  +
|     |  |     |              |     |        |        |  |  |
+  +--+  +  +  +--+  +--+--+  +--+  +--+  +  +  +--+--+  +  +
|     |     |        |     |     |     |  |     |        |  |
+  +  +--+--+--+--+--+--+  +--+  +--+  +--+--+--+  +--+--+  +
|  |        |                 |  |  |     |        |     |  |
+--+  +--+  +--+--+  +--+--+--+  +  +--+  +  +--+--+--+  +  +
|     |           |  |           |     |  |           |     |
+  +--+  +--+--+  +  +  +--+--+--+  +  +  +--+--+--+  +  +--+
|     |  |     |     |           |  |  |  |        |  |  |  G
+  +  +--+  +  +--+--+--+--+--+  +  +--+  +  +--+  +  +  +  +
|  |        |                    |           |        |     |
+--+--+--+--+--+--+--+--+--+--+--+--+--+--+--+--+--+--+--+--+