+--+--+--+--+--+--+--+--+--+--+--+--+--+--+--+--+--+--+--+--+
G  |     |                 |              |     |           |
+  +  +  +--+  +  +--+--+--+  +--+  +--+  +  +  +  +--+  +--+
|     |     |  |  |        |     |  |     |  |  |     |     |
+  +--+--+  +--+  +  +--+  +--+  +  +  +--+  +  +  +--+--+  +
|     |     |     |     |  |     |  |  |  |  |     |     |  |
+--+  +  +--+  +--+  +--+  +  +--+  +  +  +  +--+--+  +  +  +
|     |     |        |     |     |  |  |           |  |     |
+  +--+--+  +--+  +--+  +  +--+  +  +  +--+--+--+--+  +--+  +
|     |  |     |  |  |  |     |  |  |              |     |  |
+--+  +  +--+  +  +  +  +--+--+  +  +--+--+--+--+  +--+  +  +
|        |     |     |     |     |     |  |        |     |  |
+  +--+--+  +--+--+--+--+  +  +--+--+  +  +  +--+--+  +--+  +
|  |  |     |           |        |     |  |           |     |
+  +  +--+--+  +--+--+  +--+--+--+  +--+  +--+--+--+--+  +--+
|  |           |     |              |           |     |  |  |
+  +--+  +--+  +  +  +--+--+--+--+--+  +  +--+--+  +  +  +  +
|     |  |     |  |     |     |     |  |  |        |     |  |
+--+  +--+  +--+  +--+  +  +  +  +  +  +  +  +--+--+--+--+  +
|           |        |     |     |     |                    S
+--+--+--+--+--+--+--+--+--+--+--+--+--+--+--+--+--+--+--+--+